TCCAAGCTGGGCTGTGTGCACGAACCCCC
AGTTCGATGTAACCCACTCGTGCACCCAA
CGTTCAGC|ACGCTGTAGGTATCTC|TCTCCTGT
AAGCGTGG|CCTGTCCGCCTTTCTC|CACAAAAA
TCCGACCC|AAACCCGACAGGACTA|GCCGCGTT
AGGTGGCG|TGCCGCTTACCGGATA|CGCTTTCT
TCGACGCT|CCCCCCTGACGAGCAT|GCGGTAAT
GCTGGCGT|TAACGCAGGAAAGAAC|CTGCGCTC
AGATCCTT|GCGCAGAAAAAAAGGA|GTATTTGG
TCAGGGGA|TTTTCCATAGGCTCCG|CAAGTCAG
ACGGTTAT|ATCAGCTCACTCAAAG|TCGTGCCA
GGTCGTTC|CGCGGGGAGAGGCGGT|ACATTAAT
AAGTATAT|AAAATGAAGTTTTAAA|TCTCAAGA
GGCCAACG|GGCTGCGGCGAGCGGT|CCACAGAA
ACCATCTG|GATAACTACGATACGG|TCAATCTA
CCACACAA|GCTCACTGCCCGCTTT|AATGAATC
TAATTGTT|TTTATCCGCCTCCATC|GAGGGCTT
GCTGCATT|CCAGTCGGGAAACCTG|TGAAATTG
TGCGTTGC|CATACGAGCCGGAAGC|TGCAGGCA
TTATCCGC|ATAGCTGTTTCCTGTG|GGGTAACG
TGCAAGCT|TGTAAAACGACGGCCA|TATTACGC
CACGACGT|TGGCGTAATCATGGTC|TCACAATT
CCAGGGTT|GCAAGGCGATTAAGTT|GATGCGTA
CAGCTGGC|CATTCGCCATTCAGGC|AGCAGATT
GCGAGTTA|CAGCTCCGGTTCCCAA|CAGTCTAT
TCAGGCGC|GAAAGGGGGATGTGCT|TTCCCAGT
AGGAGAAA|TGTGAAATACCGCACA|TGTAAGCG
GTACTGAG|CAGGGCGCGTCAGCGG|GTGAAAAC
ATCCGTAA|GCATAATTCTCTTACT|CGATCAAG
AAGCCCGT|AGTGCACCATATGCGG|ATACCGCA
CATCATTG|ACATAGCAGAACTTTA|GTCATGCC
AAGCCAGT|GCAAGCAGCAGATTAC|TGATCTTT
TTTTGTTT|TACCTTCGGAAAAAGA|ACAGAGTT
TCTACGGG|AGATCCTTTTAAATTA|ATGAGTAA
CTTCACCT|GTCTGACGCTCAGTGG|GGTGGTTT
ACTTGGTC|GACTCCCCGTCGTGTA|GCCCCAGT
AGTTGCCT|TGACAGTTACCAATGC|AAAAGGAT
CGAGCGCA|GATACCGCGAGACCCA|TCATCCAT
GCTGCAAT|GAAGTGGTCCTGCAAC|GCCGGGAA
GCTAGAGT|TTGGTATGGCTTCATT|CATGATCC
CTCGTCGT|AAGTAGTTCGCCAGTT|GGAAGGGC
CCCATGTT|TGGTTATGGCAGCACT|GATGCTTT
ATCACTCA|GTGCAAAAAAGCGGTT|GTGTCACG
TCTGTGAC|GGGATAATACCGCGCC|GAAAACGT
GTCAATAC|TGGTGAGTACTCAACC|GCAGTGTT
CTGATCTT|GCGAAAACTCTCAAGG|TGCCCGGC
TATCTGCG|CTACACTAGAAGAACA|CTTGAGTCCAACCCGG
TAAGACACGACTTATC|GGTGGCCTAACTACGG|CTCTGCTG
GATGCCGG|ACGGTCACAGCTTGTC|TGAGCAAAAACAGGAA
GGCAAAATGCCGCAAA|CATGCAGCTCCCGGAG|GAGCAGAC
CCTGGAAGCTCCCTCGTGCGC|AGTTCGGTGTAGGTCGTTCGC
AAGGCCAGGAACCGTAAAAAG|TAAAGATACCAGGCGTTTCCC
GCTTCCTCGCTCACTGACTCG|ATGTGAGCAAAAGGCCAGCAA
GCCTAATGAGTGAGCTAACTC|TTGCGTATTGGGCGCTCTTCC
GGGGATCCTCTAGAGTCGACC|ATAAAGTGTAAAGCCTGGGGT
GATCGGTGCGGGCCTCTTCGC|GTGAATTCGAGCTCGGTACCC
GGCTTAACTATGCGGCATCAG|TGCGCAACTGTTGGGAAGGGC
TCGCGCGTTTCGGTGATGACG|GTGTTGGCGGGTGTCGGGGCT
GCGAGGTATGTAGGCGGTGCT|GTTGGTAGCTCTTGATCCGGC
AAACAAACCACCGCTGGTAGC|AACGAAAACTCACGTTAAGGG
ATTTTGGTCATGAGATTATCA|TTAATCAGTGAGGCACCTATC
TCAGCGATCTGTCTATTTCGT|CGCTCACCGGCTCCAGATTTA
TCAGCAATAAACCAGCCAGCC|AATAGTTTGCGCAACGTTGTT
GCCATTGCTACAGGCATCGTG|AGCTCCTTCGGTCCTCCGATC
GTTGTCAGAAGTAAGTTGGCC|AAGTCATTCTGAGAATAGTGT
ATGCGGCGACCGAGTTGCTCT|ATCTTACCGCTGTTGAGATCC
CTCTGACA|AAAGGGAATAAGGGCGACACGGAAATGTTGAATACTC
CTTGAAGT|GCCACTGGCAGCAGCCACTGGTAACAGGATTAGCAGA
CATAGCTC|CCGACCGCTGCGCCTTATCCGGTAACTATCGT|CCTTCGGG
TCTTCGGG|CAGCATCTTTTACTTTCACCAGCGTTTCTGGG|AAAGTGCT
