AAAAAAGG|ACAACCATCGCCCACG|CGGGTAAA
GGAAAGCG|ACCAGGCGGATAAGTG|AATAGGTG
GAACGTGG|CGAGAAAGGAAGGGAA|CAAACTAT
CGATTTTA|GAGGACAGATGAACGG|CGCGACCT
CATATTTA|GAAATACCGACCGTGT|TACCTTTT
AGTTTGGA|GCCCTTCACCGCCTGG|TTGCGCTC
TTATTCAT|AGGGAAGGTAAATATT|CATTCAGT
CAGCGAAA|AACTTTCAACAGTTTC|TGGGATTT
GCAAATAT|CGCGTCTGGCCTTCCT|GGCCTCAG
AATCACCA|AATAGAAAATTCATAT|ATAACGGA
GAGCAAAA|ACTTCTGAATAATGGA|AGAAGGAG
ACGCTCAA|AATAAGAATAAACACC|GTGAATTT
ATACCCAA|GATAACCCACAAGAAT|AAACGATT
ACCCGTCG|TCATATGTACCCCGGT|AAAGGCTA
ACGTTAGT|AAATGAATTTTCTGTA|AGCGGAGT
TATTTTGC|TCCCAATCCAAATAAG|TGAGTTAA
AGTGTACT|TGAAAGTATTAAGAGG|CCGCCACC
AATGCCCC|GTAACAGTGCCCGTAT|GTGAATTT
TTTCAACT|ATAGGCTGGCTGACCT|TGTATCAT
TATATTTT|AGCTGATAAATTAATG|TTGTATAA
ATTGAGGG|TAAAGGTGAATTATCA|ATCACCGG
TAAGCGTC|GAAGGATTAGGATTAG|TACCGCCA
ACGGCTAC|TTACTTAGCCGGAACG|CTGACCAA
TAAGTCCT|ACCAAGTACCGCACTC|TTAGTTGC
CTCATCTT|GAGGCAAAAGAATACA|CTCCCTCA
AGGCGGTC|ATTAGTCTTTAATGCG|CAATATTA
CATTCAAC|GCGAGAGGCTTTTGCA|TATTATAG
GCGCATTA|GCTTATCCGGTATTCT|AAATCAGA
CAAGCCCA|ATAGGAACCCATGTAC|CGTAACAC
TAAATATT|GGAAGAAAAATCTACG|ACCAGTCA
AGGCGTTA|CAGTAGGGCTTAATTG|ACAATAGA
TTTTAATT|GCCCGAAAGACTTCAA|TTCCAGAG
GGAAATAC|CTACATTTTGACGCTC|ACCTGAAA
TTTTGTTT|AAGCCTTAAATCAAGA|ATCGAGAA
AATAATAA|GGTCGCTGAGGCTTGC|AAAGACTT
TCTTACCA|GCCAGTTACAAAATAA|ATGAAATA
CCAAATCA|CTTGCCCTGACGAGAA|CGCCAAAA
AGAGAATC|GGTTGTACCAAAAACA|AGCATAAA
TAAAGTAC|CGCGAGAAAACTTTTT|ATCGCAAG
CAAAAATC|ATTGCTCCTTTTGATA|AGTTTCAT
AGGGTTGA|ATAAATCCTCATTAAA|TGATATTC
GTGAGCTA|GTTTCCTGTGTGAAAT|TTGGGAAG
GGGAGAGG|TGTAAAACGACGGCCA|TTCCCAGT
TCATTACC|CGACAATAAACAACAT|ATTTAGGC
ACGAACCA|AAACATCGCCATTAAA|TGGTGGTT
CTAAAGCA|AGATAGAACCCTTCTG|AATCGTCT
CGACAACT|AAGTATTAGACTTTAC|AGCCGGAA
AGCGCCAA|CCATTTGGGAATTAGA|TTATTAGC
GCTCCATG|AGAGGCTTTGAGGACT|AGGGAGTT
TCGGTTTA|GCTTGATACCGATAGT|CCAACCTA
ACCCAAAT|CAAGTTTTTTGGGGTC|AAAGAACG
TTATTACG|GTCAGAGGGTAATTGA|ATAGCAGC
CAATGACA|CTCCAAAAGGAGCCTT|ACAACGCC
AGAAAAGC|AACATTAAATGTGAGC|ATCTGCCA
TTTTTGCG|CAGAAAACGAGAATGA|ATGTTTAG
GTAAAGCA|CTAAATCGGAACCCTA|GTTGTTCC
CTAATTTA|TCTTTCCTTATCATTC|ATCCTGAA
GCATAAAG|TTCCACACAACATACG|AAACAATT
TAGAATCC|CTGAGAAGAGTCAATA|GGAATCAT
TTGAATTA|TGCTGATGCAAATCCA|CAAATATA
CTTTTACA|CAGATGAATATACAGT|AAGCGCCA
AATGCAGA|CCGTTTTTATTTTCAT|CTTGCGGG
TATAGAAG|CGACAAAAGGTAAAGT|AGAGAATA
GCTAAATC|CTGTAGCTCAACATGT|ATTGCTGA
TTAAGACG|TTGAAAACATAGCGAT|TTAAATCA
CCGCCAGC|CATTGCAACAGGAAAA|ATATTTTT
CGGCCTTG|CTGGTAATATCCAGAA|CGAACTGA
CTTTGAAA|AGAACTGGCTCATTAT|TTAATAAA
GATTGACC|GATGAACGGTAATCGT|AGCAAACA
TTTCATGA|AAATTGTGTCGAAATC|TGTACAGA
GGAATTAC|TCGTTTACCAGACGAC|AAAAGATT
AGCACCGT|TAAAGGTGGCAACATA|GTAGAAAA
CTTTCATC|CCCAAAAACAGGAAGA|CCGGAGAG
TTCGCCAT|TGCCGGAAACCAGGCA|AACAGTAC
GCCCAATA|CCGAGGAAACGCAATA|GGTTTACC
AACCAGAG|ACCCTCAGAACCGCCA|GGGGTCAG
TCAGAAGC|CTCCAACAGGTCAGGA|TCTGCGAA
CGAGTAGA|ACTAATAGTAGTAGCA|AACCCTCA
CCGGAAAC|ACACCACGGAATAAGT|AAGACTCC
TATCAGGG|CGGTTTGCGTATTGGG|AACGCGCG
GGATTTAG|CGTATTAAATCCTTTG|TTTTCAGG
CTGTAATA|TTGCCTGAGAGTCTGG|AAAACTAG
CTCAGAGC|CACCACCCTCATTTTC|CTATTATT
CCAGCAGG|GGCAAAATCCCTTATA|AAGCCGGC
ACGAGTAG|TGACAAGAACCGGATA|TACCAAGC
GAGAATAG|CTTTTGCGGGATCGTC|GGGTAGCA
GCGTAAGA|GAGAGCCAGCAGCAAA|AAGGTTAT
GATGGCAA|AATCAATATCTGGTCA|CAAATATC
CTTTACAG|TTAGCGAACCTCCCGA|CGTAGGAA
AGTAATCT|TAAATTGGGCTTGAGA|GAATACCA
CGATGGCCCACTACGT|AAACCGTC
CCTAATTT|ACGCTAACGAGCGTCT|ATATCGCG
CGTAACGA|TCTAAAGTTTTGTCGT|GAATTGCG
TAACCTCC|ATATGTGAGTGAATAA|ACAAAATC
ATCAAAAT|CGTCGCTATTAATTAA|CGGATTCG
CAATAAAT|ACAGTTGATTCCCAAT|TTAGAGAG
TGAGTTTC|GTCACCAGTACAAACT|TAATTGTA
AAAAGTAA|TATCTTACCGAAGCCC|AACACTAT
GAGCCGCC|CCACCACCGGAACCGC|CTAAAACA
AGATTAGA|TTTAAAAGTTTGAGTA|CACGTAAA
GCGTTATA|GAAAAAGCCTGTTTAG|AAGGCCGG
TCACAATC|GTAGCACCATTACCAT|CGTTTTCA
ATTATTTA|ACCCAGCTACAATTTT|CAAGAACG
TAGCCCTA|CCAGCAGAAGATAAAA|ACATTTGA
TCCATATA|CATACAGGCAAGGCAA|CTTTATTT
CGGAATTA|TTGAAAGGAATTGAGG|TGAAAAAT
GAATAGCC|GCAAGCGGTCCACGCT|CCTAATGA
GGTAGCTA|GGATAAAAATTTTTAG|TTAACATC
GGTATTAA|GAACAAGAAAAATAAT|TAAAGCCA
CCCTCAGA|ACCGCCACCCTCAGAA|CTGAGACT
CCCGGGTA|CTTTCCAGTCGGGAAA|CGGGCAAC
CTTGCATG|CATTAATGAATCGGCC|CGCCAGGG
ATCAACAG|TCATCATATTCCTGAT|TGATTGTT
CACCAGAG|TTCGGTCATAGCCCCC|GCCAGCAA
CTGAAACA|GGTAATAAGTTTTAAC|CCCTCAGA
ATTTTGCG|TCTTTAGGAGCACTAA|GCAACAGT
CGCCTGAT|GGAAGTTTCCATTAAA|CATAACCG
TGCAACTA|AGCAATAAAGCCTCAG|TTATGACC
CTGTAAAT|CATAGGTCTGAGAGAC|GATAAATA
GAAGCAAA|AAAGCGGATTGCATCA|GATAAAAA
GACTTGAG|AGACAAAAGGGCGACA|AGTTACCA
TCAGGTCA|CTTTTGCGGGAGAAGC|AGAATTAG
CCAGGCGC|TTAATCATTGTGAATT|ACAGGTAG
GAAGATCG|GTGCGGGCCTCTTCGC|AATCATGG
GGCGATCG|CACTCCAGCCAGCTTT|GCCATCAA
ATCAGAGA|AAGAACTGGCATGATT|TTATTTTG
ATATAATG|CATTGAATCCCCCTCA|AATCGTCA
ATCGGCTG|CGAGCATGTAGAAACC|AGCTATAT
AAATAATT|TTAAATTGTAAACGTT|GATATTCA
TATAAGTATAGCCCGG|CCGTCGAG
TGGTTTTT|AACGTCAAAGGGCGAA|GAACCATC
CAGCTGGC|GGACGACGACAGTATC|GTAGCCAG
AGAGGCAT|AATTTCATCTTCTGAC|TATAACTA
TCATAGCT|ACTCACATTAATTGCG|CCCTGAGA
AGACAGTC|ATTCAAAAGGGTGAGA|TATCATAT
CCTCAAGA|ATACATGGCTTTTGAT|AGAACCAC
AACCTACC|GCGAATTATTCATTTC|CAGTACAT
CATGTCAA|GATTCTCCGTGGGAAC|CGTTGGTG
CTTAAACA|TCAGCTTGCTTTCGAG|AAACAGTT
ACAAAGAA|ATTAATTACATTTAAC|ACATCAAG
CAACGCAA|TTTTTGAGAGATCTAC|TGATAATC
CACGACGT|GTAATGGGATAGGTCA|AAACGGCG
GAAATGGA|TTATTTACATTGGCAG|ACATTCTG
TACATACA|GACGGGAGAATTAACT|ACAGGGAA
TGAGGCAG|GCGTCAGACTGTAGCG|TAGCAAGG
AATGGTTT|ACAACGCCAACATGTA|GTTCAGCT
TGCCTTTA|GTCAGACGATTGGCCT|GCCAGAAT
GAAGGAAA|ATAAGAGCAAGAAACA|ACAGCCAT
ATTAAGTT|CGCATCGTAACCGTGC|GAGTAACA
GTTTGCCA|CCTCAGAGCCGCCACC|GATACAGG
TGTAGCAT|TCCACAGACAGCCCTC|ATCTCCAA
ACCGTTCT|AAATGCAATGCCTGAG|AGGTGGCA
TATGTAAA|CCTTTTTTAATGGAAA|AATTACCT
AAAGATTC|AGGGGGTAATAGTAAA|CCATAAAT
TATCACCG|TACTCAGGAGGTTTAG|CGGGGTTT
AAACCCTC|ACCAGTAATAAAAGGG|ATTCACCA
GCCACCAC|TCTTTTCATAATCAAA|CCGTCACC
GCTCATTT|TCGCATTAAATTTTTG|AGCTTAGA
TCAATTCT|TTTAGTTTGACCATTA|CCAGACCG
TTTGCCAG|ATCAGTTGAGATTTAG|TGGTTTAA
GTTAAAAT|TTTAACCAATAGGAAC|CCGGCACC
GAATGGCT|AGTATTAACACCGCCT|CAACTAAT
GAGTTGCA|CGAGATAGGGTTGAGT|AAGGGAGC
TTTCATTT|GGTCAATAACCTGTTT|AATCAATA
TTATTAAT|GCCGTCAATAGATAAT|CAGAGGTG
ACTGCCCG|CCGAGCTCGAATTCGT|TATTACGC
TGAACAAA|CAGTATGTTAGCAAAC|TAAAAGAA
CCTGATTG|AAAGAAATTGCGTAGA|CCCGAACG
GCTTCTGG|TCAGGCTGCGCAACTG|TGTTATCC
CCCCGATT|TAGAGCTTGACGGGGA|AATCAAAA
TTTTAGTT|TTTCGAGCCAGTAATA|AATTCTGT
TCGGCATT|CCGCCGCCAGCATTGA|CGTTCCAG
TAGATGGG|GGGTAACGCCAGGGTT|GTGCCAAG
GTTTGAGG|GAAAGGGGGATGTGCT|AGAGGATC
GCGCAGAG|ATATCAAAATTATTTG|ACATTATC
GCCAACAG|TCACCTTGCTGAACCT|GTTGGCAA
CCAGACGA|GCGCCCAATAGCAAGC|AAGAACGC
GCCAGCTG|CCTGCAGGTCGACTCT|GCAAGGCG
ACAAACAA|AATCAGTAGCGACAGA|TCGATAGC
AAATCAAT|GGCTTAGGTTGGGTTA|CTAAATTT
TGCTCAGT|CAGTCTCTGAATTTAC|CAGGAGGT
TGCCTTGA|CTGCCTATTTCGGAAC|AGGGATAG
AGGTTTTG|AACGTCAAAAATGAAA|GCGCTAAT
ACGCAAAG|GTCACCAATGAAACCA|ATCAAGTT
TGGATTAT|GAAGATGATGAAACAA|AATTTCAT
ACAGAAAT|CTTTGAATACCAAGTT|CCTTGCTT
GAATAAGG|ACGTAACAAAGCTGCT|GACGGAAA
TACCTTTA|AGGTCTTTACCCTGAC|AAAGAAGT
AAACAGTT|GATGGCTTAGAGCTTA|TTTAAATA
AAGAGGAA|CGAGCTTCAAAGCGAA|GATACATT
TCGCAAAT|GGGGCGCGAGCTGAAA|TAATGTGT
AGCTGATT|ACAAGAGTCCACTATT|GAGGTGCC
ACGGTCAA|GACAGCATCGGAACGA|ACCCTCAG
TGGACTCC|CTTTTCACCAGTGAGA|CCTGTCGT
CAAAATTA|AAGTACGGTGTCTGGA|AGAGGTCA
GCAATAGC|GCAGATAGCCGAACAA|TTCAACCG
AGGTAAAG|AAATCACCATCAATAT|AATATTTT
GCTCACAA|TGTAAAGCCTGGGGTG|GGTTTGCC
AAACGAAA|TGACCCCCAGCGATTA|TTCATTAC
AAAGGCCG|AAAGGAACAACTAAAG|CTTTCCAG
ATACGTAA|AAGTACAACGGAGATT|TCATCAAG
ACTGGATA|ACGGAACAACATTATT|ACCTTATG
GAGGCGTT|AGAGAATAACATAAAA|GAACACCC
CCGAAATC|CGAAAATCCTGTTTGA|AATACCGA
AAAACAAA|TTCATCAATATAATCC|TATCAGAT
TTTAACGT|TCGGGAGAAACAATAA|TTTTCCCT
ATATATTC|TTTTTTCACGTTGAAA|ATAGTTAG
ACGAACTA|GCGTCCAATACTGCGG|AATGCTTT
CTAAAATA|GAACAAAGAAACCACC|AGGGTTAG
GGACGTTG|TCATAAGGGAACCGAA|AGGCGCAG
CAAGCAAG|ACGCGCCTGTTTATCA|AGAATCGC
GCCACGCT|ATACGTGGCACAGACA|ACGCTCAT
CATAACCC|GAGGCATAGTAAGAGC|TTTTTAAG
CCAAAATA|TAATGCAGATACATAA|ACACCAGA
AATTACTA|CAAATTCTTACCAGTA|ATCCCATC
GCGAAACA|TGCCACTACGAAGGCA|TGCGCCGA
