TTTCGCCCTAACTATGTCCGCCTTCTTTC
AACGCAGCAATCTGCTACGAGTAGTATAG
TGACCTTA|CCTGACTCAACCAGGC|TTTACACT
TTCACTCT|GCATAGTCGAAACCAT|CTTCGTGA
GCTTTAAG|GTCATAGCTAATTCCG|ATAGCCGG
TAGGAACT|GAGGATGTGCATCTGA|GCGAACAG
GGGCCTCT|GAGGTTGAGCGCGTTT|CCGTGGTT
ACTGAACA|TATACTGAGTATTCTA|CCGCCGTG
CACGGATA|GTCAGGTTAGCGACAC|CTCAGCAG
AAAACGAT|TCCCCCGATTCCTAGT|GTCAACTT
TGAGACAA|AGCGCTTGGTGAGATC|CGCCAGCT
ATGCCTCA|TCGATTTCACATTGCA|ATCCCAAA
CCACGGTA|GCCGCCCCAACCGTGA|TTGGACAT
ATTACTCG|AACGCTGACAGATTAT|CACGCATA
AAGTGTAC|GTTAGTTTTCTAAAAT|GGAAGTGG
ATTCGCTG|CTTCCTTAGATGTAGC|GTCGCGTG
ATTATGTA|TGTCGATCTTTGCGTA|AGTTAACG
GGAGAGCT|CTCGCTACCTGCGGCA|AGATGAGG
TTAGTCTC|GTGGCCCTGATGCCAC|CCGAGGGT
TCAGTATG|TGTGTCACTTCGCGCT|TCCGGCGT
GTCTCTCG|ATTTTGGCGAAGGAGA|GTGGGTCA
GACTATAC|ATACCGCCATCCGTGT|GGCTTCTA
CCTTAAAG|AGTAGACAGGACTGCG|GATGCAAG
TCCATACA|TGCGCGCGACGGGACA|TCCCTGGC
CTTCTGTA|AGTTCTCCTTGCTCCT|AACTTAGC
AAGTCTTC|CTATTTGACATTACGA|TGAGTCCC
AATACGCT|AAAATAAGAGAGATGC|CTCCCTTG
GCCACTTT|CAGAGCCATAGGCGAC|AAGAAGAA
TCGGTCAT|TTAGAGCACGCGAAAG|TCTAACGT
GTATCGGT|ATCCAGTGAGCCGTCG|GGGCGGCT
AAACTCGA|CGGGCCAAAGATTTGG|ATGGATGA
TTACTATT|GCTGCGATAAGCAAGT|CTGACCCT
ACGTATGT|AGACCTCTTGGCTCTC|GTGCGACC
AGTCTAAG|CGCACACATGCGTCCA|ATATGGGG
AGGGCCGA|TAACCACTATCGTGTA|TCAGTCCA
TGGGGCAG|GCTATTCAGCTATCCA|GTCATCCC
CTCCATGT|CCTGAGCAACGAAGTA|CGCTTTTG
CTCAATTT|GCAGGGAGGCTAGGCA|CTTTCATG
TTTATGAA|TAGACGCAATTCTGAT|CATTTGCC
TGCTTCGG|GAAGGGAAAATCCTGA|ACCGATCG
TATTTAGC|CTACACCAACGCCACG|ACAGTGCC
TCGAGTCA|GGTAGCGCCCGTAATG|GTTTATCC
TTGCATTC|GAGAATAGTAACAAAA|GCGGTTTT
CGTACACA|TAGCCAAGCCAGGTCT|CAATCGTA
GTAGGCTT|GGTTCGGTTGCCTTTC|CGGCAGCC
TGGCTTGT|TGACGATATATCGCAT|GCGATTAG
ATGACACG|GTATCCGAAGACACTT|CAAGAAAC
CTTACTTT|GAGGCAACTCACTGAT|TAGTCCTA
TGCGAGCGAATAACCGACAGT|TCACCATTGTTTTGTCTGCAA
CCCGCATCCTTCCCATATGCT|TCTTGTCGTCCTGGACCTAAT
ACCCAGCCTATTACCTAGAGA|TGTTCTAGTTCGTAACCTTGG
GAATCCGCACTTACCGTAGTC|AGCACTCCCACCTTCATTGAC
GCTGTGTGCCGGGCAATGCCC|AAATAGACTTAATCGCCGCGC
GCTGTCTTAGGGACCCGGCTC|TTTCAGGCTCAGACATAGAAA
GTCAATGTACTTATTGCTGGG|TGACGCGGCCCGGGTAATCCC
CTGGTACTCCACTCGGGCGCG|TCCGTTAGGTCACCGGGATCG
ACAGACGGAAATTGAACCTAT|GGTGTGAAGTTTAGTGACTAC
TAACCCGACGAGCCCGCGTCA|TGCACCGCTTATCTGTTTCTT
CAAACAGGGTCGTTTTAACTT|GCCACCGAACCGCGAGGTAAC
TCCTGCCCTTATACGAACTTT|GGAAACGTACGTGAACGGCAC
AGGACAACGTGCCTAAATCTC|ATGAGCTTTGTTCCCCATGCC
GGACAGCGTATAAGTCGGTGA|AACTACTTCCAAGTTGGCCGC
AATGCACGACGCCGATGACGT|CGTTCAGAGTACATTCAAACC
AGCTCACGTGGATCACACTCA|TCCGACCGCAAGGGGTTAAGT
AATTTTTC|AAGATACGTTGTTGGGTACAGGTGAAAGCGAGATAAT
TGTGAGGG|TGCCAGAACCAATCCACACCTACTGCATACCTTTTCG
AAAGGACG|GTTTAATTTCTCAAGTGCAGGATAGCGTTATCGACAAGCG
GCAGAGAC|TATAGGTACGATTGCCCATCGCGGGTCTCACAGCCCAGGG
GGCGTTCGCAAATGTCTATAAAAC|ATTAAAAATTCACCCT|GTTTCCTG
TCGCACGGCTAAAGTGAATCGGGG|CGGTCTGAAGCCGACT|ACCATCTT
