AGTTAGTT|ACTTAATAGATCCAGA|ACACTAAC
CCCAGATA|GACGTAATCTGTGCGG|TGAGTGAG
GCGAGAATTCTTGAGGTCATTCTT|ACATCGGA
GCGTTGTG|TCTATGAAATAGCAAA|ACCCGCAG
TGACACCT|TGGAAGGGCCGAGACC|AAACTTCC
TCTACGGA|TGTTCAGGAGCACGAG|CTAACCGA
ACGTGACA|GTAACATCAGCAACGG|GGGCGAAA
CCGCAAAG|CCAGCAATCATATGCG|TGTACATC
GTCATGGC|CAGATTTCAGTGCACT|AGTGAAAC
CTCACAGC|ACCAGCGGGACCCATG|TTCTGTGA
TCCTAGAAGAGTTGATATCGGAGC|GTGGGCGC
GAACACCT|CCTACTCGTAACTGCA|GCTGACAG
GTTGGGCT|AGCAGGAATCGGCAAA|CGCAACAC
TATGACCT|AACGCCAATCAACATC|CATCCCTC
GTTTAGGA|GGCGTATTATTCGACC|GGGGTTTT
ATGGCAACAATGACGCTGCAGCTTTGCGTGCA
TGAATGGG|TTCATACCTTCCCCTG|CATCCACT
CGTACTAA|TATTCTGGTTCCGTCC|TCAGACAA
ATAATCAA|CGGCTTCCCGTCGACA|TGCCATGG
ACGTTTCC|GTTTACCGATTACACG|GAAGATAT
CTGTCTAG|TATCGACCCGGGAAAT|CAGAGCAT
ATATCCAA|AGCTGATTCTCTACAC|GTATCATA
ACGACTGT|GTGGTAGTCAATCGAA|TGGCCGTT
TACTGCCG|CGTGCGAAATTGTTCG|CATCCAGC
GCCTTGTG|CATACGGTTTCGGGCG|TCTGCGGG
TAAACCAC|GTAATTGAGGATCGGA|TATGCCGC
GTTCGATT|GATACAATGGTCGGCA|TAGGAACA
CCTGAGTT|ACGACCTTACGAACCA|TAGGCAGG
ACGTCAGA|CACCACCTTTTATCCT|ATGGGTAG
CAGTAGGG|TTTAAACGCAGTGGGG|AACATGTT
CGCCTACA|GGCCATCTTTCAGCGA|ACTAACGA
AAGTTCCC|GCCCGGCTGGACGCAT|CGCCATCA
TTGTGGCA|CTGATATTGAGCCGAG|CGTCCTGG
CTGAGATA|TTTGCTTTATTGTTGA|CCTGAGGG
TGAAACCC|CGACGTAGGTGCGGTA|CCGTCACA
ACACAGAA|CTTGACCGACACGCGT|AGAAATTT
GAGGACTG|AGCCATAATAGGGAAC|CCCAGTCA
TTCAGGTC|ATTACCGTCCTTGTAC|CTTCTAGA
CCTCCCTC|CTAGTTCGCCACTAAT|GTTGTGAC
TTCGCTCG|ACAGGTGTGTCGAACG|GGCGTAGC
CCGAATGC|CGGTCTCACTGGGATG|ACTACCTG
GTGCTGGT|ACACTACAGCAGTAAA|TAACTCAC
AAACCCAA|ACAATTTAGAAAGCAC|ACCACCAA
CTGCGTAT|TCCACCTATCGAAGGA|CTACACCT
ACATTAAA|TAGACCGGGGTGCGCT|TATATCGA
CGTGGTTT|GTAATCCATTGTGCGC|GAAAGTGG
GTTAGGCC|TTGCTCCTAATCGTCG|GGCTTAAG
ATGCGTTG|AACCAGTTATCCCGCA|GACTTGAG
ACGGTAAT|CTCTTTGGCGAGGTAA|TTTGCATT
CCGCGGAC|TCTGGGGTTGTCAACT|GAACGCAT
CAAGAGCT|TTCCCTGCTACTCAAC|TCACTCCG
TTGTATAA|GACGCCCATTGCTGGA|AGTCACCT
GTGCAACC|GGGTTCGAGTCTCAAA|CTCGCCAG
GTCTTAAT|TTAGCTAGATCTCCAC|GCGACCTA
CAAAACAC|TGTAGAAATACGGCTG|GCGCAAGC
TCTATACT|AAGGTATTGGCGCATG|AGCGTTCA
CCGGCACC|CATGTGGTTCACTTCA|GAACGAGT
CTAAGCTA|CCTGCTGGCCGATGCG|AGGCCACG
TTAGGCGC|CCTAGGTGTTGGCGGC|GGTTGTAG
ACAGTCTT|CCGCCCGGTCGGGTAG|ACGCAGAG
CGCACTTA|CGCGAGGGACAGGGTG|GGACCTCC
CTTTGGTC|TAACGGCAAGGTCGAA|GGGGCCCT
CCACTTTC|CTCGTGCGCGCCACCT|ATATTTCT
GAGACCCC|GGCGCTGAGCTATTCC|GTGTACGC
CCCGCGTT|ATTAAGGGTGCCCGCT|TAGATCAT
TATGTTTG|CGTGTCCGTGTCTGAC|CACGTTGA
TGGGCGTC|GAGCAAGTGGGAATAG|ATCCCGGG
GTTAATAT|GAAGAGCAGCTAACGG|TGTTAAAG
AGGAACGT|AATTATTTCGCCTTTC|CTGGGGGG
CGCCAAAG|TGTTACAACAGTCCGG|CCGGTTAC
CTCAGCCC|AGCATTGAGAGGTATA|TGCATATG
TCAGCGTT|CCACAACTATTTGTGA|GCCATTAG
TGACCGCC|TGCGTACCGGGTCACA|TTTCGCAC
CAATGTAT|ATACGACATATCACAC|TGCAGAAT
CTACCCGAGCGGCTTA|GTAGTACG
GTAGAAGG|GCCGACATCCTGAGAG|AATCCCAC
AATAAGCG|CGAAGAGAGTGTTGAG|TAGCGTTG
ACCCAATT|GTCTGGTCGTAAGTAT|AGACGCGC
AATCAGAC|TCCTCAAGGACCTGTG|TCCCGCGA
AAACTATG|CGCTTTTCTGGGTTTC|CCTCTCTC
CTAGTATAGGGTGGATGCCCCGTA|GGTTTGAG
AGACGTTT|CCGTGCCGTTGTTAAG|CGCCGTCA
ATTAGGTA|TACCAGGAGACATACC|ATGTTATGTGGGCCAG
ACGGTCCT|AAACTCGTCATGTCTA|TCAGGTAG
AACGATAT|CTGGACATTTGGTGTA|TTGGGGCT
GCACCTTC|ATATGTCCGGGTGCAT|CCGGAAAG
CGTGTATG|GTTTTAGCAGGCCAGA|GAGGCGCA
GTCGAAGCGCCCGACCATGGTCAC|GGCAGGGA
TAACACATGAATGTAAAAGTCGGC|CCACGATG
AATATTTT|CTCCGAGATGTGGCTG|TCATGGGG
GTCACTAT|TCGGTAAAGTGTTTTC|CGTAGTGT
TGCGTCTG|GGAGATTTACAAAGCT|ACGTCTCT
AGCCATCC|AGCTTTACCCGTGAAA|TGATGACG
TTAGCCGT|TATGTATCGTGCTATT|CCGTCTTT
CGCTTATA|CGCTAACTTAGGCAAG|CTTCCATG
AGGCGGCT|AGTGTAACCGTCGTCG|TCCGACCT
AAGGCCTT|CGCTACTGGCTGTCAT|GGACCGGA
CCAACGGA|TAGGGCCCAATAGCCT|GCTTTAAC
GCTATGGC|CCTCGCGCACAGTAAG|ATGTAGGC
GAAGTGTGATGCACATCTCTGTCC|GCATAGTA
AGACCCAC|TGGGCGGAGCGCGGAA|CCCCGGGG
TCCACAGA|CATTACAGGGATTGTT|AATTGCTA
GAAACTGA|TAAGAAAGGAGTCTTC|CGACCCTG
CCGGGGGA|TTCTGCATCGTTTTAT|CCCACCGT
TGAGGGAGTCGGTTTGTAACTCTC|AGCCCCAT
GGCGGACG|GGTCAGTGGTCCAACA|ACCGACTT
CCTCGAAT|AGCGGGTCGTCAAAAG|AACTTGCA
TGCTTACC|AGCTGTAAATGCCCAT|CGTTCCGG
ACCTGAGCGCTGCCCCTAGGGATG|CGGCCGCT
TATAGATA|TTGTGCCGATAGGTGA|AATTAGGA
CATACTCA|TTGCGTCAACACGTGC|ACGGTGGT
ACTATGCT|TAGTACAAAATACTAG|AACTGTCG
GGCATTTC|AAAGTACTTACCACGT|TGATTGTA
GACGGTTG|CTAAATCTTTTCCATT|AACTCTTC
TGACCCCA|AATCACAACGTGAATT|TGTAAGCG
TCGCATGC|TGTCTGGAAACGTGCA|CAACAGCT
CCCCGCACCAGTATTTTAGGGCGG|CTCGACTG
GTCTAATT|CATCGTAGGGGATACC|CTGATTTG
CCAGGTCT|ATGGACAGTTACTATT|ACACTTCT
CTGCACTT|CTGCAGGTCAACGTCA|TAAGCAAG
AGTTTCGA|ACATGCTCTACTCCGT|CACCACGG
AAGAGATG|TTACTGCTTCGCAGAA|CATTGTAA
GAAAATTA|ACGTTCCTTTGTTCCA|CCTCCACC
TGTGCAGT|GCCAGTTTCCTTCATG|TGAGTCTG
ATGTGAAT|GGATCCCATACCGCGT|ACTTAGCA
CACACCCT|AAATCAAACGAGGCAC|CTGCACCG
ACAGAATT|CGCAAACGTTTTTCCC|CAGGAGTG
GTCATCAATAGAATCGCGGAGTGA|ATTGATTC
CCATCTCG|GGTAAAATGGCCAGGA|CGATGCCT
GTGTCAGT|GGCTCCCTATTTAGGC|GATGCAAG
GTACGACC|ATCCTACCAAATTGGT|GCCCGGGT
GCTAGTCA|AAAGGCACTCCCCCAT|ATGTCACG
GTGAGTCC|TGACAGCACCAAGCGA|TTCTCCTG
TGTGCCTC|GGTGACACTAGGGTCG|GGCAGCGT
GACCCCGC|GCGTAACCACATGCGC|TCCTAAAC
CTGAGTCA|GCGCATTCGGGACATG|ACTAAGGA
ATAAAGCT|ATACACCAGGTTCGGC|ACGCTTAA
TGGACACT|GCCGCCTATCAAATGC|GGATCGAG
TCTTCTAT|GCGGTCGACGCCTTAC|TTCACATC
AGCCTTTT|CTTTAAAGTATACGGG|CCTGTTCC
CGACAACTCCGCAACCAACCTTCA|CAGGTGAG
AACGACTA|CGCTGGATGTTCCGCA|TTCCATCG
GTAGCGAGGATTCCGT|ACCTAGAC
ATCAAAGT|GAGTGGTTACATCTTC|GAAAAGAG
CCGTCAGC|TCGAGCAGACTCAAGT|GTAGAGGG
GAGTTAAG|CTGTCAAATCCTAAGG|ATCGACTC
CCCAGGTG|GGCATGCCCTCTTACT|TCTGTATG
GGACTCGA|CAGACAGGAGGTTAGC|CCGCTTAG
GCTGGTTA|GTTCGCGCGGTACGAG|ACATCCGT
GGCACCGT|ATACGCCCCGCCGGTA|GGTCCCCC
AAAATTCT|AAGCCACGACGAAGTT|ATGCCCGA
GGTAGCGT|ACTCGCGAAGGCTATG|GAAGAACC
ACTATGAT|GGAAGCAGAGTAACGA|ACGCTCAG
CCATATTT|CTGATGTGCAATACCG|TTGCCGTC
TCGGCTGT|ATAGTAGGTACTGTCA|GGCTGAAC
CAACCGAC|GCACATAGTGCTTGTA|AACAAGGC
TCTGTCTT|GATTTTACCAATGCTT|CGGATGCG
GAGGATATTTACCTCCTCACGGGA|GAAAGCTC
AGCCCCCT|GACGTGTAAACTAATT|TGTTTCAG
CCGGAAGG|GCCAATGTCCTGAAGA|TTCAGCAC
GGTTAGTCCGTCATTTTATTCCGG|CTAAGAGC
CATCAGTA|TAATAGCTACAAGGTA|TAATGGAG
AGGTCGGA|CATCACAGAGGCTCGG|CAATACAG
CCAGCACG|CTTGCTGCTAAGTCGC|ACACTCGA
ATACATAT|AGAACGGCGGGGTATA|GCGCAGAC
GGAAGCTG|AGCCCAAGCCATGCCA|CTGTATAG
ACCCGACT|GGATCAATCCAACTTT|TTCCGTGG
CCGCATGA|CTCGAAACCGGTGCGT|TCGCTGAT
GGAGTACC|TGTTCCCAGGGAGCCC|CTCACGTA
ATCGTCTG|TGAGCACTCTCGACGT|GTAAGTGA
GCAGGTTG|CGATGCTCGATACTCC|GAGAACGC
CCCATTAC|ACTATGGGATCTCTCG|ATGAGACC
ATTTTAAT|TCGACTATTCTTAGGA|TACCTTGA
TACCACCC|CATTATACCCACATAT|CGATAGAA
GTAGCAAG|TGTGTGACTGAGCATG|CGTCGCCT
CACAAGCG|GAATCATGACCGGCCA|CAAAACTG
GCCAGCGA|GCTAACCTGGAGTAGC|ATAATGAC
TAGAAAAT|GGATTTTCACACTGCT|GTCTAACA
TTACGACG|GGGCTTGTGCTACAGG|GATAGGCT
GAACTTAC|GGGTGGTCAAGATCCG|CATGAGGC
TGATTGCT|GTAGGTTTACACATCA|AATGTAGT
TTTGCTCT|GGTGTGGTCGATCCAC|CAAGCATC
TCGTGACT|CGGTACCAACGATCTG|CGGACGAT
GCGAGACG|TACAAGAAAACTCAGA|GAGCGTAG
TAGAGCAA|ACAGAGCTGCCTCCTG|TCTTTAAG
TTTTGCTA|TAGAGGTTCCTGGAAC|TAGTGACA
ATTTTGGC|GCATTAGCCACTCTAC|GGGGGTGT
TCGGGGCG|GTAGCCCTGAACAATA|ATCATGCA
TTGACCTG|TTGGACAAAGAGGTCC|TTCAAGTG
TTCGAACA|AGATCTGGATAAGCCT|GAACACTC
ACGTTATG|ACCGGTCACGAATCCC|ACAACGGG
AAGATCTT|GGAGCGGATTGCCTAA|CTCTGCGCGATGTACG
GTGATCCC|TGTTGCAAAATGCGTC|CGAAAAAG
CCTCCAGG|TATGTGATACTGGGGC|CTAGTAAT
ATAAGCTG|AACGAACGTGGTCTGG|GACAGGCG
CTTGACTT|AATTTCATCGCGCCGC|GTGTAGGT
CGTTCAGCTTAACGACAAACTACA|TGGATCGC
GAGCTTAG|GCTCTGAGTACATACA|ACACGAGC
CATAAGAT|CATTTTTCGTCGCGTT|GTTTCCCA
CTTTGACG|GTTCCCTCCTAGCATC|TCTGTGGA
CAGTTGTT|TATCCGCTCCAGCTCG|CGCCTGAC
TTAGAGGA|CCTGTGCTCTGGCTAC|AAAATAAG
TAATACAA|TGACGGTCTGCTGTTC|GTGTGCGA
AGTATATG|TGCACCCCCTCGTGAG|TATCCCTA
CTGACGTT|GACAATGCCAGGGTAC|CTAGGCAC
CTCGTCCT|AAAGCAAAAAGGGTAT|CTGTGTCC
TACCAGAA|GTCCGCTGTGGCCCAT|CTGGGGAC
GCACGATC|AACTCCAATGGGACAA|GCGGCGCA
TGTATCCG|AAAAAGTGCCCACTAG|CGGTAAGG
CAGCTCTT|TGAGAACTACTAAGCC|TGCCACTT
GCAATCCT|TTCTGACACGATACCT|TTACTTTT
CTAAAGGTCAGCGGCGGTCCGTTT|GACCTCGT
CCGATGGA|CAAGAACTCGACACAT|ACGACTTT
GTATTAGG|TCGTATCCATGATGGG|TGTGGGGG
TATCGGGC|GTTGTTGGGGTACGCA|TGACAACA
CGGCCCGG|CTATTTCAAATACACG|GGGCAACC
